.......................................
.......................................
.......................................
.....##############################....
.......................................
.......................................
.......................................
.......................................
.....##############################....
.......................................
.......................................
.......................................
.......................................
..........#.#.#.#.#.#.#.#.#............
..........#...............#............
..........#...............#............
..........#...............#............
..........#...............#............
..........#...............#............
..........#.#.#.#.#.#.#.#.#............
.......................................
.......................................
.......................................
.......................................
.....##############################....
.......................................
.......................................
.......................................
.......................................
.....##############################....
.......................................
.......................................
.......................................
.......................................
.......................................
.......................................
.......................................
.......................................
.......................................
.......................................